0 0 0 0 0 0 0 0 0 0 0 0 0 0 0 0 0 0 0 0 0 0 0 0 0 0 0 0 0 0 0
0 0 0 0 0 0 0 0 0 0 0 0 0 0 0 0 0 0 0 0 0 0 0 0 0 0 0 0 0 0 0
0 0 0 0 0 0 0 0 0 0 0 0 0 0 0 0 0 0 0 0 0 0 0 0 0 0 0 0 0 0 0
601 602 602 602 602 602 602 602 602 602 602 602 602 607 458 392 457 608 602 602 602 602 602 602 602 602 602 602 602 602 603
625 434 460 460 460 460 460 460 460 460 460 460 460 460 461 392 459 460 460 460 460 460 460 460 460 460 460 460 460 434 627
625 458 392 392 392 392 392 392 392 392 392 392 392 392 392 392 392 392 392 392 392 392 392 392 392 392 392 392 392 457 627
625 458 392 392 392 392 392 392 392 392 392 392 392 386 386 392 392 392 392 392 392 392 392 392 392 392 392 392 392 457 627
625 458 392 392 392 392 392 392 392 392 392 392 392 386 392 386 386 392 387 387 387 392 392 392 392 392 392 392 392 457 627
625 458 392 392 392 392 392 392 392 392 391 391 386 386 386 386 392 387 387 392 387 387 387 392 392 392 392 392 392 457 627
607 458 392 392 392 392 392 392 392 391 391 389 389 389 386 389 389 387 389 387 387 387 387 387 392 392 392 392 392 457 608
460 461 392 392 392 392 392 392 392 391 391 391 391 392 389 389 389 389 389 387 387 387 392 387 392 392 392 392 392 459 460
392 392 392 392 392 392 392 391 391 391 391 391 391 391 391 391 389 389 387 387 387 392 387 392 392 392 392 392 392 392 392
436 437 392 392 392 392 391 391 392 391 391 391 391 391 391 389 389 389 389 387 387 392 387 392 392 392 392 392 392 435 436
631 458 392 392 392 392 392 392 392 392 391 391 391 391 391 392 389 389 389 392 392 392 387 392 392 392 392 392 392 457 632
625 458 392 392 392 392 392 392 392 392 392 391 392 391 391 392 392 389 389 392 392 392 392 392 392 392 392 392 392 457 627
625 458 392 392 392 392 392 392 392 392 392 392 392 392 392 392 392 389 392 392 392 392 392 392 392 392 392 392 392 457 627
625 458 392 392 392 392 392 392 392 392 392 392 392 392 392 392 392 392 392 392 392 392 392 392 392 392 392 392 392 457 627
625 458 392 392 392 392 392 392 392 392 392 392 392 392 392 392 392 392 392 392 392 392 392 392 392 392 392 392 392 457 627
625 434 436 436 436 436 436 436 436 436 436 436 436 436 437 392 435 436 436 436 436 436 436 436 436 436 436 436 436 434 627
649 650 650 650 650 650 650 650 650 650 650 650 650 631 458 392 457 632 650 650 650 650 650 650 650 650 650 650 650 650 651
