###############################
###############################
###############################
##############xxx##############
#############.....#############
#############.....#############
#############.....#############
#############.....#############
#############.....#############
#############.....#############
#############.....#############
#############.....#############
#############.#...#############
#############.....#############
#############.....#############
#############.....#############
#############.....#############
###############################
###############################
###############################
