0 0 0 0 0 0 0 0 0 0 0 0 0 0 0 0 0 0 0 0 0 0 0 0 0 0 0 0 0 0 0
0 0 0 0 0 0 0 0 0 0 0 0 0 0 0 0 0 0 0 0 0 0 0 0 0 0 0 0 0 0 0
0 0 0 0 0 0 0 0 0 0 0 0 0 0 0 0 0 0 0 0 0 0 0 0 0 0 0 0 0 0 0
601 602 602 602 602 602 602 602 602 602 602 602 603 625 458 392 457 608 602 602 602 602 602 602 602 602 602 602 602 602 603
625 434 460 460 460 460 460 460 460 460 460 434 627 625 461 392 459 460 460 460 460 391 460 460 460 460 460 460 460 434 627
625 458 388 392 392 388 388 388 388 388 392 458 627 625 458 392 392 392 392 392 392 391 391 391 392 388 388 388 388 457 627
625 458 388 388 388 388 388 392 388 388 392 458 627 625 458 392 392 391 392 391 392 392 391 391 388 388 388 388 388 457 627
625 388 388 388 388 388 388 388 388 392 392 458 627 625 458 386 386 391 391 387 387 392 392 391 391 388 388 388 388 458 627
625 458 388 388 388 388 388 388 390 392 391 458 627 625 458 386 388 388 388 388 387 387 387 391 391 388 388 388 391 457 627
625 458 388 388 388 388 388 390 390 391 391 458 627 625 458 389 388 388 388 388 388 387 387 391 391 391 391 391 391 457 608
625 458 392 388 388 388 392 390 390 391 391 458 627 625 458 388 388 388 388 388 388 387 388 388 392 392 392 391 391 459 460
625 458 392 392 388 388 390 390 390 391 391 458 627 625 458 388 388 388 387 387 387 392 387 392 392 392 392 392 392 392 392
625 458 392 388 388 390 390 390 392 391 391 458 627 625 433 436 436 436 436 436 436 436 436 436 436 436 436 436 436 436 436
625 458 392 388 388 390 388 388 392 392 391 458 627 649 650 650 650 650 650 650 650 650 650 650 650 650 650 650 650 650 650
625 458 392 388 390 388 388 388 392 392 392 458 608 602 602 602 602 602 602 602 602 602 602 602 602 602 602 602 602 602 603
625 458 392 388 388 388 390 392 392 390 390 459 458 458 458 458 458 458 458 458 458 458 458 458 458 458 458 458 458 458 627
625 458 392 390 390 390 390 392 390 390 390 390 390 390 392 390 390 390 390 390 390 390 390 390 390 390 392 392 392 457 627
625 458 392 390 390 390 390 390 390 392 392 392 392 392 390 390 392 392 392 392 392 392 390 390 390 392 392 392 392 457 627
625 434 436 436 436 436 436 436 436 436 436 436 458 458 458 458 458 436 436 436 436 436 436 436 436 436 436 436 436 434 627
649 650 650 650 650 650 650 650 650 650 650 650 650 650 650 650 650 650 650 650 650 650 650 650 650 650 650 650 650 650 651
