###############################
###############################
###############################
###############################
###############################
###############################
###############################
###############################
###.#.#.#.#.#.#################
#..............################
x.....##..##....###############
x..............################
x...##..##..##..###############
#..............################
###.#.#.#.#.#.#################
###############################
###############################
###############################
###############################
###############################
