0 0 0 0 0 0 0 0 0 0 0 0 0 0 0 0 0 0 0 0 0 0 0 0 0 0 0 0 0 0 0
0 0 0 0 0 0 0 0 0 0 0 0 0 0 0 0 0 0 0 0 0 0 0 0 0 0 0 0 0 0 0
0 0 0 0 0 0 0 0 0 0 0 0 0 0 0 0 0 0 0 0 0 0 0 0 0 0 0 0 0 0 0
338 338 338 338 338 338 338 338 338 338 338 338 338 338 338 338 338 338 338 780 338 338 338 338 338 338 338 338 338 338 338
338 338 338 338 338 338 338 338 338 338 338 338 338 338 338 338 338 338 338 338 338 338 338 338 338 338 338 338 338 338 338
338 338 338 338 338 338 338 338 338 338 338 338 338 338 338 338 338 338 338 780 338 338 338 338 338 338 338 338 338 338 338
338 338 338 338 338 338 338 338 338 338 338 338 338 338 338 338 338 338 338 338 338 338 338 338 338 338 338 338 338 338 338
338 338 338 338 338 338 338 338 338 338 338 338 338 338 338 338 338 338 338 780 338 338 338 338 338 338 338 338 338 338 338
338 338 338 392 338 392 338 392 338 392 338 392 338 392 338 338 338 338 338 338 338 338 338 338 338 338 338 338 338 338 338
338 392 392 392 392 392 392 392 392 392 392 392 392 392 392 338 338 338 338 780 338 338 338 338 338 338 338 338 338 338 338
392 392 392 392 392 392 774 774 392 392 774 774 392 392 392 392 338 338 338 338 338 338 338 338 338 338 338 338 338 338 338
392 392 392 392 392 392 392 392 392 392 392 392 392 392 392 338 338 338 338 2684355340 338 338 338 338 338 338 338 338 338 338 338
392 392 392 392 774 774 392 392 774 774 392 392 774 774 392 392 338 338 338 338 338 338 338 338 338 338 338 338 338 338 338
338 392 392 392 392 392 392 392 392 392 392 392 392 392 392 338 338 338 338 2684355340 338 338 338 338 338 338 338 338 338 338 338
338 338 338 392 338 392 338 392 338 392 338 392 338 392 338 338 338 338 338 338 338 338 338 338 338 338 338 338 338 338 338
338 338 338 338 338 338 338 338 338 338 338 338 338 338 338 338 338 338 338 2684355340 338 338 338 338 338 338 338 338 338 338 338
338 338 338 338 338 338 338 338 338 338 338 338 338 338 338 338 338 338 338 338 338 338 338 338 338 338 338 338 338 338 338
338 338 338 338 338 338 338 338 338 338 338 338 338 338 338 338 338 338 338 2684355340 338 338 338 338 338 338 338 338 338 338 338
338 338 338 338 338 338 338 338 338 338 338 338 338 338 338 338 338 338 338 338 338 338 338 338 338 338 338 338 338 338 338
338 338 338 338 338 338 338 338 338 338 338 338 338 338 338 338 338 338 338 2684355340 338 338 338 338 338 338 338 338 338 338 338
