722 722 722 722 722 722 722 722 722 722 722 722 722 722 722 722 722 722 722 722 722 722 722 722 722 722 722 722 722 722 722
722 722 722 722 722 722 722 722 722 722 722 722 722 722 722 722 722 722 722 722 722 722 722 722 722 722 722 722 722 722 722
722 722 722 722 722 722 722 722 722 722 722 722 722 722 722 722 722 722 722 722 722 722 722 722 722 722 722 722 722 722 722
722 722 722 722 673 746 746 746 746 746 746 746 746 746 388 388 388 746 746 746 746 746 746 746 746 746 673 722 722 722 722
722 722 722 722 723 386 386 386 386 386 386 386 386 386 386 386 386 386 386 386 386 386 386 386 386 386 721 722 722 722 722
722 722 722 722 723 386 386 386 386 386 386 386 386 386 386 386 386 386 386 386 386 386 386 386 386 386 721 722 722 722 722
722 722 722 722 723 386 386 386 386 386 386 386 386 386 386 386 386 386 386 386 386 386 386 386 386 386 721 722 722 722 722
722 722 722 722 723 386 386 386 386 386 386 386 386 386 386 386 386 386 386 386 386 386 386 386 386 386 721 722 722 722 722
722 722 722 722 723 386 386 386 386 386 386 386 386 386 386 386 386 386 386 386 386 386 386 386 386 386 721 722 722 722 722
722 722 722 722 723 386 386 386 386 386 386 386 386 386 386 386 386 386 386 386 386 386 386 386 386 386 721 722 722 722 722
722 722 722 722 723 386 386 386 386 386 386 386 386 386 386 386 386 386 386 386 386 386 386 386 386 386 721 722 722 722 722
722 722 722 722 723 386 386 386 386 386 386 386 386 386 386 386 386 386 386 386 386 386 386 386 386 386 721 722 722 722 722
722 722 722 722 723 386 386 386 386 386 386 386 386 386 386 386 386 386 386 386 386 386 386 386 386 386 721 722 722 722 722
722 722 722 722 723 386 386 386 386 386 386 386 386 386 386 386 386 386 386 386 386 386 386 386 386 386 721 722 722 722 722
722 722 722 722 723 386 386 386 386 386 386 386 386 386 386 386 386 386 386 386 386 386 386 386 386 386 721 722 722 722 722
722 722 722 722 723 386 386 386 386 386 386 386 386 386 386 386 386 386 386 386 386 386 386 386 386 386 721 722 722 722 722
722 722 722 722 723 386 386 386 386 386 386 386 386 386 386 386 386 386 386 386 386 386 386 386 386 386 721 722 722 722 722
722 722 722 722 723 386 386 386 386 386 386 386 386 386 386 386 386 386 386 386 386 386 386 386 386 386 721 722 722 722 722
722 722 722 722 723 386 386 386 386 386 386 386 386 386 386 386 386 386 386 386 386 386 386 386 386 386 721 722 722 722 722
722 722 722 722 673 698 698 698 698 698 698 698 698 698 388 388 388 698 698 698 698 698 698 698 698 698 673 722 722 722 722
