-T-T-IH@
LAHSHE-V
-V---JNK
-JNHR-V-
F-V---V-
V-WHHHAR
JHE---V-
--B--LSR
